111111111111111111111111111111111111111111111111111111111111111111111111111111111111111111111111111
100000000000000000000000000000000000000010000000000000000000010000000000000000000000000000000000001
101111111111111111111111111111111111110000111111111111100111111111111111111111111111111111111111111
101000000000000000000000000000000000000011111111111111101111111111111111100111111111111111111111110
101111111111111111111111111111111111111011111111111111001111111111111111001111111110000000000000001
101111111111111111111111111111111111110011111111111111011111111111111111000000000000111111111111101
101111111111111111111111111111100000011111111111111111111111111111111111111111111111111111111111101
100000000000000000000000000000000000000000000000000000000000000000000000000000000000000000000000001
101111111111111111111111111111111111111110111111111111100000000111111111111111111111111111111111111
