111111111111111
100001100110011
100001000010011
100000000000011
100000000000011
100000000100011
100000000000011
100010000000011
100000000000011
100010000100011
100000000000011
111111111111111
