000000000000000
000001100110011
000001000010000
000000000000000
000000000000000
100000000100000
100000000000000
100010000000000
100000000000000
100010000100000
100000000000011
111111111111111
